in	IN	in
this	DT	this
re-make	NN	<unknown>
of	IN	of
the	DT	the
1954	CD	@card@
japanese	JJ	Japanese
monster	NN	monster
film	NN	film
,	,	,
godzilla	NN	<unknown>
is	VBZ	be
transformed	VBN	transform
into	IN	into
a	DT	a
"	``	"
jurassic	JJ	Jurassic
park	NN	park
"	''	"
copy	NN	copy
who	WP	who
swims	VBZ	swim
from	IN	from
the	DT	the
south	RB	south
pacific	JJ	pacific
to	TO	to
new	JJ	new
york	VBP	york
for	IN	for
no	DT	no
real	JJ	real
reason	NN	reason
and	CC	and
trashes	VBZ	trash
the	DT	the
town	NN	town
.	SENT	.
although	IN	although
some	DT	some
of	IN	of
the	DT	the
destruction	NN	destruction
is	VBZ	be
entertaining	VBG	entertain
for	IN	for
a	DT	a
while	NN	while
,	,	,
it	PP	it
gets	VBZ	get
old	JJ	old
fast	RB	fast
.	SENT	.
the	DT	the
film	NN	film
often	RB	often
makes	VBZ	make
no	DT	no
sense	NN	sense
(	(	(
a	DT	a
several-hundred	JJ	<unknown>
foot	NN	foot
tall	JJ	tall
beast	NN	beast
hides	NNS	hide
in	IN	in
subway	NN	subway
tunnels	NNS	tunnel
)	)	)
,	,	,
sports	VBZ	sport
second-rate	JJ	second-rate
effects	NNS	effect
(	(	(
the	DT	the
baby	NN	baby
godzillas	NNS	<unknown>
seem	VBP	seem
to	TO	to
be	VB	be
one	CD	one
computer	NN	computer
effect	NN	effect
multiplied	VBN	multiply
on	IN	on
the	DT	the
screen	NN	screen
)	)	)
,	,	,
lame	JJ	lame
jokes	NNS	joke
(	(	(
mayor	NN	mayor
ebert	NN	<unknown>
and	CC	and
his	PP$	his
assistant	JJ	assistant
gene	NN	gene
are	VBP	be
never	RB	never
funny	JJ	funny
)	)	)
,	,	,
horrendous	JJ	horrendous
acting	NN	acting
(	(	(
even	RB	even
matthew	JJ	<unknown>
broderick	NN	<unknown>
is	VBZ	be
dull	JJ	dull
)	)	)
and	CC	and
an	DT	an
unbelievable	JJ	unbelievable
love	NN	love
story	NN	story
(	(	(
why	WRB	why
would	MD	would
anyone	NN	anyone
want	VBP	want
to	TO	to
get	VB	get
back	RB	back
together	RB	together
with	IN	with
maria	NNS	mare
pitillo	NN	<unknown>
's	POS	's
character	NN	character
?	SENT	?
)	)	)
.	SENT	.
there	EX	there
are	VBP	be
other	JJ	other
elements	NNS	element
of	IN	of
the	DT	the
film	NN	film
that	WDT	that
fall	VBP	fall
flat	JJ	flat
,	,	,
but	CC	but
going	VBG	go
on	IN	on
would	MD	would
just	RB	just
be	VB	be
a	DT	a
waste	NN	waste
of	IN	of
good	JJ	good
words	NNS	word
.	SENT	.
only	RB	only
for	IN	for
die-hard	JJ	die-hard
creature	NN	creature
feature	NN	feature
fans	NNS	fan
,	,	,
this	DT	this
might	MD	might
be	VB	be
fun	NN	fun
if	IN	if
you	PP	you
could	MD	could
check	VB	check
your	PP$	your
brain	NN	brain
at	IN	at
the	DT	the
door	NN	door
.	SENT	.
i	NP	i
could	MD	could
n't	RB	n't
.	SENT	.
(	(	(
michael	NP	Michael
redman	NP	Redman
has	VBZ	have
written	VBN	write
this	DT	this
column	NN	column
for	IN	for
23	CD	@card@
years	NNS	year
and	CC	and
has	VBZ	have
seldom	RB	seldom
had	VBN	have
a	DT	a
more	JJR	more
disorienting	VBG	disorient
cinematic	JJ	cinematic
experience	NN	experience
than	IN	than
seeing	VBG	see
both	DT	both
"	``	"
fear	NN	fear
and	CC	and
loathing	NN	loathing
"	''	"
and	CC	and
"	``	"
godzilla	NN	<unknown>
"	''	"
in	IN	in
the	DT	the
same	JJ	same
evening	NN	evening
.	SENT	.
)	)	)
