this	DT	this
talky	JJ	talky
,	,	,
terribly-plotted	JJ	<unknown>
thriller	NN	thriller
stars	VBZ	star
alec	NN	alec
baldwin	NNS	<unknown>
as	IN	as
dave	NN	<unknown>
robicheaux	NNS	<unknown>
,	,	,
an	DT	an
ex-new	NP	<unknown>
orleans	NP	Orleans
cop	NN	cop
who	WP	who
gets	VBZ	get
ensnared	VBN	ensnare
in	IN	in
a	DT	a
murder-	NN	<unknown>
mystery	NN	mystery
after	IN	after
a	DT	a
light-plane	NN	<unknown>
crashes	VBZ	crash
into	IN	into
the	DT	the
bayou	NN	bayou
beside	IN	beside
his	PP$	his
fishing	NN	fishing
boat	NN	boat
.	SENT	.
he	PP	he
and	CC	and
his	PP$	his
wife	NN	wife
annie	NN	<unknown>
(	(	(
kelly	NNS	<unknown>
lynch	VBP	lynch
)	)	)
rescue	VB	rescue
a	DT	a
little	JJ	little
salvadorian	JJ	Salvadorian
girl	NN	girl
(	(	(
samantha	NN	<unknown>
lagpacan	NN	<unknown>
)	)	)
from	IN	from
the	DT	the
wreckage	NN	wreckage
and	CC	and
that	DT	that
's	VBZ	be
when	WRB	when
the	DT	the
trouble	NN	trouble
begins	VBZ	begin
.	SENT	.
the	DT	the
other	JJ	other
major	JJ	major
players	NNS	player
include	VBP	include
a	DT	a
local	JJ	local
drug	NN	drug
lord	NN	lord
(	(	(
eric	NN	eric
roberts	NNS	<unknown>
)	)	)
,	,	,
his	PP$	his
scheming	JJ	scheming
wife	NN	wife
(	(	(
teri	NN	<unknown>
hatcher	NN	hatcher
)	)	)
,	,	,
a	DT	a
soused	VBN	souse
stripper	NN	stripper
(	(	(
mary	NN	<unknown>
stuart	NP	Stuart
masterson	NP	Masterson
)	)	)
,	,	,
and	CC	and
a	DT	a
shady	JJ	shady
dea	NN	<unknown>
agent	NN	agent
(	(	(
vondie	NN	<unknown>
curtis	NN	<unknown>
hall	NN	hall
)	)	)
.	SENT	.
everyone	NN	everyone
knows	VBZ	know
everyone	NN	everyone
else	RB	else
and	CC	and
it	PP	it
makes	VBZ	make
for	IN	for
a	DT	a
collective	NN	collective
that	WDT	that
's	VBZ	be
curious	JJ	curious
but	CC	but
never	RB	never
compelling	JJ	compelling
.	SENT	.
based	VBN	base
on	IN	on
the	DT	the
book	NN	book
by	IN	by
james	NNS	<unknown>
lee	JJ	lee
burke	VBP	burke
,	,	,
heaven	NN	heaven
's	POS	's
prisoners	NNS	prisoner
is	VBZ	be
so	RB	so
badly	RB	badly
plotted	VBD	plot
that	DT	that
entire	NN	entire
*	SYM	*
scenes	NNS	scene
*	SYM	*
seem	VBP	seem
to	TO	to
be	VB	be
missing	VBG	miss
.	SENT	.
early	RB	early
on	RB	on
,	,	,
we	PP	we
have	VBP	have
no	DT	no
idea	NN	idea
of	IN	of
why	WRB	why
dave	NN	<unknown>
and	CC	and
annie	NN	<unknown>
keep	VBP	keep
the	DT	the
child	NN	child
to	TO	to
themselves	PP	themselves
.	SENT	.
nor	CC	nor
how	WRB	how
they	PP	they
eluded	VBD	elude
both	CC	both
the	DT	the
coast	NN	coast
guard	NN	guard
and	CC	and
the	DT	the
faa	NN	<unknown>
.	SENT	.
later	RBR	later
,	,	,
dave	NN	<unknown>
is	VBZ	be
reunited	VBN	reunite
with	IN	with
a	DT	a
drug-abuser	NN	<unknown>
who	WP	who
appears	VBZ	appear
seemingly	RB	seemingly
clean	VB	clean
and	CC	and
sober	VB	sober
and	CC	and
without	IN	without
any	DT	any
explanation	NN	explanation
.	SENT	.
huh	NP	Huh
?	SENT	?
the	DT	the
whole	JJ	whole
movie	NN	movie
is	VBZ	be
like	IN	like
this	DT	this
,	,	,
perhaps	RB	perhaps
the	DT	the
result	NN	result
of	IN	of
some	DT	some
unkind	JJ	unkind
cuts	NNS	cut
that	WDT	that
happened	VBD	happen
during	IN	during
the	DT	the
eighteen	CD	eighteen
months	NNS	month
that		IN	that
the	DT	the
film	NN	film
sat	VBD	sit
on	IN	on
the	DT	the
shelf	NN	shelf
.	SENT	.
whatever	WDT	whatever
the	DT	the
reason	NN	reason
,	,	,
somebody	NN	somebody
should	MD	should
tell	VB	tell
director	NN	director
phil	NN	<unknown>
joanou	NN	<unknown>
(	(	(
final	JJ	final
analysis	NN	analysis
)	)	)
to	TO	to
recut	VB	<unknown>
this	DT	this
mess	NN	mess
.	SENT	.
in	IN	in
its	PP$	its
present	JJ	present
form	NN	form
,	,	,
heaven	NN	heaven
's	POS	's
prisoners	NNS	prisoner
runs	VBZ	run
only	RB	only
two	CD	two
hours	NNS	hour
plus	CC	plus
change	NN	change
,	,	,
but	CC	but
it	PP	it
feels	VBZ	feel
like	IN	like
four	CD	four
.	SENT	.
