a	DT	a
couple	NN	couple
of	IN	of
criminals	NNS	criminal
(	(	(
mario	NP	Mario
van	NP	van
peebles	NNS	<unknown>
and	CC	and
loretta	NN	<unknown>
devine	NN	<unknown>
)	)	)
move	NN	move
into	IN	into
a	DT	a
rich	JJ	rich
family	NN	family
's	POS	's
house	NN	house
in	IN	in
hopes	NNS	hope
of	IN	of
conning	VBG	con
them	PP	them
out	RP	out
of	IN	of
their	PP$	their
jewels	NNS	jewel
.	SENT	.
however	RB	however
,	,	,
someone	NN	someone
else	RB	else
steals	VBZ	steal
the	DT	the
jewels	NNS	jewel
before	IN	before
they	PP	they
are	VBP	be
able	JJ	able
to	TO	to
get	VB	get
to	TO	to
them	PP	them
.	SENT	.
writer	NN	writer
mario	NN	<unknown>
van	NN	van
peebles	NNS	<unknown>
delivers	VBZ	deliver
a	DT	a
clever	JJ	clever
script	NN	script
with	IN	with
several	JJ	several
unexpected	JJ	unexpected
plot	NN	plot
twists	NNS	twist
,	,	,
but	CC	but
director	NN	director
mario	NN	<unknown>
van	NN	van
peebles	NNS	<unknown>
undermines	VBZ	undermine
his	PP$	his
own	JJ	own
high	JJ	high
points	NNS	point
with	IN	with
haphazard	JJ	haphazard
camera	NN	camera
work	NN	work
,	,	,
editing	VBG	edit
and	CC	and
pacing	VBG	pace
.	SENT	.
it	PP	it
felt	VBD	feel
as	RB	as
though	IN	though
the	DT	the
film	NN	film
should	MD	should
have	VB	have
been	VBN	be
wrapping	VBG	wrap
up	RP	up
at	IN	at
the	DT	the
hour	NN	hour
mark	NN	mark
,	,	,
but	CC	but
alas	UH	alas
there	EX	there
was	VBD	be
still	RB	still
35	CD	@card@
more	JJR	more
minutes	NNS	minute
to	TO	to
go	VB	go
.	SENT	.
daniel	NP	Daniel
baldwin	NP	Baldwin
(	(	(
i	NP	i
ca	MD	ca
n't	RB	n't
believe	VB	believe
i	NNS	i
'm	VBP	be
about	RB	about
to	TO	to
type	VB	type
this	DT	this
)	)	)
gives	VBZ	give
the	DT	the
best	JJS	good
performance	NN	performance
in	IN	in
the	DT	the
film	NN	film
,	,	,
outshining	VBG	outshine
the	DT	the
other	JJ	other
talented	JJ	talented
members	NNS	member
of	IN	of
the	DT	the
cast	NN	cast
.	SENT	.
[	SYM	[
r	SYM	r
]	SYM	]
