deserves	VBZ	deserve
recognition	NN	recognition
for	IN	for
:	:	:
making	VBG	make
this	DT	this
relatively	RB	relatively
youthful	JJ	youthful
critic	NN	critic
feel	VBP	feel
extremely	RB	extremely
old	JJ	old
and	CC	and
crotchety20	JJ	<unknown>
capsule	NN	capsule
review	NN	review
:	:	:
this	DT	this
is	VBZ	be
what	WP	what
feel-good	JJ	feel-good
family	NN	family
entertainment	NN	entertainment
has	VBZ	have
morphed	VBN	<unknown>
into	IN	into
in	IN	in
the	DT	the
90	CD	@card@
's	VBZ	be
:	:	:
an	DT	an
hour-and-a-half	NN	hour-and-a-half
commercial	NN	commercial
,	,	,
disguised	VBN	disguise
as	IN	as
an	DT	an
unnecessary	JJ	unnecessary
remake	NN	remake
,	,	,
in	IN	in
which	WDT	which
the	DT	the
defining	VBG	define
image	NN	image
is	VBZ	be
that		IN	that
of	IN	of
a	DT	a
grown	VBN	grow
man	NN	man
launching	VBG	launch
a	DT	a
volume	NN	volume
of	IN	of
green	JJ	green
protoplasmic	JJ	protoplasmic
goo	NN	goo
out	IN	out
of	IN	of
his	PP$	his
ass	NN	ass
.	SENT	.
(	(	(
between	IN	between
this	DT	this
,	,	,
rocketman	NN	<unknown>
,	,	,
and	CC	and
george	NN	<unknown>
of	IN	of
the	DT	the
jungle	NN	jungle
,	,	,
disney	NP	Disney
has	VBZ	have
recently	RB	recently
eclipsed	VBN	eclipse
longtime	JJ	longtime
champion	NN	champion
troma	NN	<unknown>
as	IN	as
the	DT	the
studio	NN	studio
most	RBS	most
likely	JJ	likely
to	TO	to
include	VB	include
a	DT	a
fart	NN	fart
joke	NN	joke
in	IN	in
a	DT	a
film	NN	film
.	SENT	.
)	)	)
as	IN	as
the	DT	the
absent-minded	JJ	absent-minded
professor	NN	professor
who	WP	who
invents	VBZ	invent
the	DT	the
titular	JJ	titular
computer-generated	JJ	computer-generated
goop	NN	goop
,	,	,
a	DT	a
listless	JJ	listless
robin	NN	robin
williams	NP	Williams
manages	VBZ	manage
the	DT	the
difficult	JJ	difficult
task	NN	task
of	IN	of
making	VBG	make
original	JJ	original
lead	JJ	lead
fred	NP	Fred
macmurray	NN	<unknown>
seem	VBP	seem
sprightly	JJ	sprightly
.	SENT	.
the	DT	the
only	JJ	only
thing	NN	thing
that	WDT	that
made	VBD	make
this	DT	this
film	NN	film
borderline	NN	borderline
tolerable	JJ	tolerable
for	IN	for
me	PP	me
is	VBZ	be
my	PP$	my
newly-founded	JJ	<unknown>
but	CC	but
firm	JJ	firm
belief	NN	belief
that		IN	that
writer/	JJ	<unknown>
producer	NN	producer
john	NN	john
hughes	NNS	<unknown>
is	VBZ	be
going	VBG	go
to	TO	to
spend	VB	spend
his	PP$	his
eternal	JJ	eternal
afterlife	NN	afterlife
being	VBG	be
conked	VBN	conk
in	IN	in
the	DT	the
noggin	NN	noggin
by	IN	by
all	DT	all
of	IN	of
the	DT	the
different	JJ	different
blunt	JJ	blunt
instruments	NNS	instrument
he	PP	he
's	VBZ	be
used	VBN	use
for	IN	for
comedic	JJ	comedic
effect	NN	effect
in	IN	in
films	NNS	film
like	IN	like
this	DT	this
and	CC	and
the	DT	the
odious	JJ	odious
home	NN	home
alone	JJ	alone
series	NN	series
.	SENT	.
take	VB	take
your	PP$	your
kids	NNS	kid
to	TO	to
see	VB	see
boogie	VB	boogie
nights	NNS	night
instead	RB	instead
.	SENT	.
