the	DT	the
second	JJ	second
serial-killer	NN	<unknown>
thriller	NN	thriller
of	IN	of
the	DT	the
month	NN	month
is	VBZ	be
just	RB	just
awful	JJ	awful
.	SENT	.
oh	UH	oh
,	,	,
it	PP	it
starts	VBZ	start
deceptively	RB	deceptively
okay	JJ	okay
,	,	,
with	IN	with
a	DT	a
handful	NN	handful
of	IN	of
intriguing	JJ	intriguing
characters	NNS	character
and	CC	and
some	DT	some
solid	JJ	solid
location	NN	location
work	NN	work
.	SENT	.
after	IN	after
a	DT	a
baby-sitter	NN	baby-sitter
gets	VBZ	get
gutted	VBN	gut
in	IN	in
the	DT	the
suit-	NN	<unknown>
ably	RB	ably
spooky	JJ	spooky
someone's-in-the-house	NN	<unknown>
prologue	NN	prologue
,	,	,
parallel	JJ	parallel
stories	NNS	storey
unfold	VBP	unfold
,	,	,
the	DT	the
first	JJ	first
involving	VBG	involve
a	DT	a
texas	NNS	<unknown>
sheriff	NN	sheriff
(	(	(
r	LS	r
.	SENT	.
lee	JJ	lee
emery	NN	emery
)	)	)
,	,	,
a	DT	a
gruesome	JJ	gruesome
double	JJ	double
murder	NN	murder
,	,	,
and	CC	and
the	DT	the
arrival	NN	arrival
of	IN	of
a	DT	a
morose	JJ	morose
fbi	NP	<unknown>
agent	NN	agent
(	(	(
dennis	NN	<unknown>
quaid	NNS	<unknown>
)	)	)
on	IN	on
the	DT	the
eve	NN	eve
of	IN	of
voting	NN	voting
for	IN	for
the	DT	the
local	JJ	local
lawman	NN	lawman
's	POS	's
reelection	NN	reelection
.	SENT	.
the	DT	the
second	JJ	second
pairs	NNS	pair
a	DT	a
hitch-	NN	<unknown>
hiker	NN	hiker
(	(	(
jared	JJ	<unknown>
leto	NN	<unknown>
)	)	)
with	IN	with
a	DT	a
friendly	JJ	friendly
former	JJ	former
railroad	NN	railroad
worker	NN	worker
(	(	(
danny	NN	danny
glover	NN	glover
)	)	)
.	SENT	.
they	PP	they
're	VBP	be
headed	VBN	head
west	RB	west
,	,	,
toward	IN	toward
the	DT	the
rockies	NNS	<unknown>
and	CC	and
away	RB	away
from	IN	from
the	DT	the
murder	NN	murder
scene	NN	scene
.	SENT	.
which	WDT	which
one	PP	one
is	VBZ	be
the	DT	the
killer	NN	killer
?	SENT	?
well	RB	well
,	,	,
it	PP	it
does	VBZ	do
n't	RB	n't
really	RB	really
matter	VB	matter
,	,	,
'cause	IN	because
when	WRB	when
writer/	JJ	<unknown>
first-time	JJ	first-time
director	NN	director
jeb	NP	Jeb
stuart	NP	Stuart
(	(	(
die	VB	die
hard	JJ	hard
)	)	)
finally	RB	finally
spills	VBZ	spill
the	DT	the
beans	NNS	bean
,	,	,
you	PP	you
wo	MD	wo
n't	RB	n't
take	VB	take
his	PP$	his
choice	NN	choice
seriously	RB	seriously
anyway	RB	anyway
.	SENT	.
the	DT	the
whole	JJ	whole
thing	NN	thing
goes	VBZ	go
south	RB	south
about	IN	about
an	DT	an
hour	NN	hour
in	IN	in
,	,	,
with	IN	with
the	DT	the
tale	NN	tale
taking	VBG	take
hairpin	NN	hairpin
turns	VBZ	turn
that		IN	that
i	NP	i
certainly	RB	certainly
could	MD	could
n't	RB	n't
follow	VB	follow
.	SENT	.
and	CC	and
through	IN	through
the	DT	the
whole	JJ	whole
thing	NN	thing
there	EX	there
's	VBZ	be
quaid	NN	<unknown>
,	,	,
playing	VBG	play
with	IN	with
the	DT	the
most	RBS	most
intense	JJ	intense
monotony	NN	monotony
this	DT	this
side	NN	side
of	IN	of
steven	JJ	<unknown>
sea-	NN	<unknown>
gal	NN	gal
.	SENT	.
i	NNS	i
guess	VBP	guess
i	NNS	i
'm	VBP	be
glad	JJ	glad
that		IN	that
i	NP	i
did	VBD	do
n't	RB	n't
walk	VB	walk
out--	JJ	<unknown>
there	EX	there
's	VBZ	be
some	DT	some
nice	JJ	nice
train	NN	train
stuff	NN	stuff
at	IN	at
the	DT	the
end	NN	end
and	CC	and
a	DT	a
fun	NN	fun
nod	NN	nod
to	TO	to
dr	NN	Dr
.	SENT	.
strangelove	NN	<unknown>
.	SENT	.
