the	DT	the
thirteenth	JJ	thirteenth
floor	NN	floor
is	VBZ	be
a	DT	a
bland	JJ	bland
,	,	,
obligatory	JJ	obligatory
exercise	NN	exercise
in	IN	in
genre	NN	genre
film-making	NN	film-making
.	SENT	.
if	IN	if
i	NP	i
had	VBD	have
n't	RB	n't
recently	RB	recently
watched	VBN	watch
the	DT	the
matrix	NN	matrix
and	CC	and
open	VB	open
your	PP$	your
eyes	NNS	eye
--	:	--
both	DT	both
of	IN	of
which	WDT	which
are	VBP	be
similar	JJ	similar
but	CC	but
far	RB	far
superior	JJ	superior
--	:	--
i	NP	i
might	MD	might
have	VB	have
been	VBN	be
a	DT	a
little	RB	little
nicer	JJR	nice
to	TO	to
this	DT	this
picture	NN	picture
.	SENT	.
craig	NP	Craig
bierko	NP	<unknown>
makes	VBZ	make
an	DT	an
adequate	JJ	adequate
hero	NN	hero
as	IN	as
douglas	NNS	<unknown>
hall	NN	hall
,	,	,
the	DT	the
rich	JJ	rich
co-creator	NN	co-creator
of	IN	of
a	DT	a
perfect	JJ	perfect
human	JJ	human
world	NN	world
simulation	NN	simulation
who	WP	who
is	VBZ	be
suddenly	RB	suddenly
blamed	VBN	blame
for	IN	for
the	DT	the
murder	NN	murder
of	IN	of
his	PP$	his
boss	NN	boss
(	(	(
armin	NN	<unknown>
mueller-stahl	NNS	<unknown>
)	)	)
.	SENT	.
everything	NN	everything
that	WDT	that
was	VBD	be
subtle	JJ	subtle
and	CC	and
smart	JJ	smart
about	IN	about
the	DT	the
previously	RB	previously
mentioned	VBN	mention
films	NNS	film
is	VBZ	be
battered	VBN	batter
over	IN	over
our	PP$	our
heads	NNS	head
in	IN	in
this	DT	this
one	CD	one
,	,	,
and	CC	and
characters	NNS	character
stare	VBP	stare
at	IN	at
each	DT	each
other	JJ	other
for	IN	for
maddeningly-long	JJ	<unknown>
periods	NNS	period
of	IN	of
time	NN	time
and	CC	and
refuse	VBP	refuse
to	TO	to
communicate	VB	communicate
on	IN	on
any	DT	any
realistic	JJ	realistic
level	NN	level
.	SENT	.
the	DT	the
acting	NN	acting
is	VBZ	be
okay	JJ	okay
,	,	,
but	CC	but
the	DT	the
film	NN	film
suffers	VBZ	suffer
from	IN	from
every	DT	every
logical	JJ	logical
flaw	NN	flaw
one	PP	one
could	MD	could
think	VB	think
of	IN	of
,	,	,
and	CC	and
features	VBZ	feature
a	DT	a
script	NN	script
(	(	(
co-penned	VBN	<unknown>
by	IN	by
director	NN	director
josef	NP	Josef
rusnak	NP	Rusnak
)	)	)
loaded	VBD	load
with	IN	with
cliches	NNS	clich
and	CC	and
stock	NN	stock
characters	NNS	character
.	SENT	.
there	EX	there
are	VBP	be
individual	JJ	individual
scenes	NNS	scene
and	CC	and
ideas	NNS	idea
that	WDT	that
work	NN	work
--	:	--
i	NP	i
like	IN	like
the	DT	the
thought	NN	thought
of	IN	of
a	DT	a
sentient	JJ	sentient
computer	NN	computer
program	NN	program
--	:	--
but	CC	but
none	NN	none
of	IN	of
the	DT	the
film	NN	film
's	POS	's
strengths	NNS	strength
are	VBP	be
recognized	VBN	recognize
to	TO	to
any	DT	any
meaningful	JJ	meaningful
degree	NN	degree
.	SENT	.
producer	NN	producer
roland	NN	<unknown>
emmerich	NNS	<unknown>
,	,	,
based	VBN	base
on	IN	on
this	DT	this
and	CC	and
his	PP$	his
previous	JJ	previous
directorial	JJ	directorial
efforts	NNS	effort
,	,	,
seems	VBZ	seem
hell-bent	NN	hell-bent
on	IN	on
bringing	VBG	bring
us	PP	us
the	DT	the
ultimate	JJ	ultimate
standard	NN	standard
in	IN	in
mediocre	JJ	mediocre
science-fiction	NN	science-fiction
.	SENT	.
